###### ###
 ##### ###
  ####  ##
#  ### ###
 #  ## ###
 ## ##  ##
 ##  ##  #
 ### ## ##
 ###    ##
 #########
